# Circumflex map

# header
1					# field number
20					# width
20					# height
ffffff,000000		# colors

# field 1
00000000000000000000
00000000000000000000
00000000000000000000
00000000000000000000
00000000000000000000
00000000000000000000
00000000000000000000
00110000000000001100
00010000000000001000
00010100000000101000
00001100000000110000
00000000000000000000
00000001111110000000
00000000000000000000
00001100000000110000
00010100000000101000
00010000000000001000
00110000000000001100
00000000000000000000
00000000000000000000
00000000000000000000
00000000000000000000
