# Circumflex map

# header
1					# field number
20					# width
20					# height
ffffff,000000		# colors

# field 1
00000000000000000000
00000000000000000000
00000000000000000000
00000000000000000000
00000000000100000000
00000000011000000000
00000000010011100100
00000000010000111000
00000000001110011000
00000000000000000000
00000000001110011000
00000000010000111000
00000000010011100100
00000000011000000000
00000000000100000000
00000000000000000000
00000000000000000000
00000000000000000000
00000000000000000000
00000000000000000000
