# Circumflex map

# header
1					# field number
20					# width
20					# height
ffffff,000000		# colors

# field 1
00000000000000000000
00000000001100000000
00000000001010110100
00000000000010101100
00000000000011000000
00000000000000000000
00000000000000000000
00000111110000011000
00001000010000011000
00000000010000000000
00001000100000000000
00000010000000000000
00000000000000000000
00000000000000000000
00000000000000000000
00000000000000000000
00000000000000000000
00000000000000000000
00000000000000000000
00000000000000000000
